w w w w w w w w w w w w w w w w w w w w w w w w w w w
+ + + + + + + + + + + + + + + + + + + + + + + + + + +
+ + + + + + + + + + + + + + + + + + + + + + + + + + +
b b b b b b b b b b b b b b b b b b b b b b b b b b b
s s s s s s s s s s s s s s s s s s s s s s s s s s s
l l l l l l l l l l l l l l l l l l l l l l l l l l l
w w w w w w w w w w w w w w w w w w w w w w w w w w w
o o o o o o o o o o o o o o o o o o o o o o o o o o o
r r r r r r r r r r r r r r r r r r r r r r r r r r r
g g g g g g g g g g g g g g g g g g g g g g g g g g g
w w w w w w w w w w w w w w w w w w w w w w w w w w w
p p p p p p p p p p p p p p p p p p p p p p p p p p p
v v v v v v v v v v v v v v v v v v v v v v v v v v v
+ + + + + + + + + + + + + + + + + + + + + + + + + + +
