+ + + + + + + + + + + + + + + + + g g g g g g g + + +
+ + + o o o o o o o o + + + + + g g g g g g g g g + +
+ o o o y y y y y y o o o + w g g g w w w w w g g g w
o o y y y w a a w y y y o o w g g w w w w w w w g g w
o o y y y w y y w y y y o o w g g g w w w w w g g g w
o o o o y y y y y y o o o o w g g g g g g g g g g g w
+ o o o o o o o o o o o o + + w w g g g g g g g w w +
w w w o o o o o o o o w w w + w g w w g g g w w g w +
g g w w w w g g w w w w g g + w g g g w w w g g g w +
g g g g w w g g w w g g g g + w g g g g g g g g g w +
g g g g g w g g w g g g g g + w g g g g g g g g g w +
+ g g g g w g g w g g g g + + w g g g g g g g g g w +
+ + g g g w g g w g g g + + + w w g g g g g g g w w +
+ + + + g g g g g g + + + + + + + w g g g g g w + + +
