a a a a a a a o o a a a a a a a a a o o a a a a a a a
a a a a a a o o o o a a o o o a a o o o o a a a a a a
a a a a a a o o o o o o o o o o o o o o o a a a a a a
a a a a a a a o o o o o o o o o o o o o a a a a a a a
a a a a a a a o o o o o o o o o o o o o a a a a a a a
a a a a a a o o o o w a o o o o o w a o o a a a a a a
a a a a a a o o o o w w o w w w o w w o o a a a a a a
a a a a a a o o o o o o o o w o o o o o o a a a a a a
a a a a a a a o o o o o o o o o o o o o a a a a a a a
a a a a a a a a o o o o o o o o o o o a a a a a a a a
a a a a a a a a a a r r r o r r r a a a a a a a a a a
a a a a a a a a a a o r r r r r o a a a a a a a a a a
a a a a a a a a a o a r r r r r a o a a a a a a a a a
a a a a a a a a a a a o o o o o a a a a a a a a a a a
